xxxxxxxxxxxxxxxxxxxxxxxxxxxxxxxxxxxxxxxxxxxxxxxxxxxxxxxxxxxxxxxxxxxxxxxxxxxxxxxxxxxxxxxxxxxxxxxxxxxxxxxxxxxxxxxxxxxxxxxxxxxxxxxxxxxxxxxxxxxxxxxxxxx
x                                                                                                                                                 x
x                                                                                                                                                 x
x                                                                                                                                                 x
x                                                                                                                                                 x
x                                                                                                                                                 x
x                                                                                                                                                 x
x                     P                                                                                                                           x
x                                                                                                                                                 x
x                                                                                                                                                 x
x                                                                                                                                                 x
x                                                                                                                                                 x
x                                                                                                                                                 x
x                                                                                                                                                 x
x                                                                                                                                                 x
x                                                                                                                                                 x
x                               zzzzzzz                                                                                                           x
x             xxx               zzzzzzz                                                                                                           x
xxxxxxx    xxxxxxxxxxxxxxxxxxxxxxxxxxxxxxxxxxxxxxxxxxxxxxxxxxxxxxxxxxxxxxxxxxxxxxxxxxxxxxxxxxxxxxxxxxxxxxxxxxxxxxxxxxxxxxxxxxxxxxxxxxxxxxxxxxxxxxxx




000000000000000000000000000000000000000000000000000000000000000000000000000000000000000000000000000000000000000000000000000000000000000000000000000
000000000000000000000000000000000000000000000000000000000000000000000000000000000000000000000000000000000000000000000000000000000000000000000000000
000000000000000000000000000000000000000000000000000000000000000000000000000000000000000000000000000000000000000000000000000000000000000000000000000
