xxxxxxxxxxxxxxxxxxxxxxxxxxxxxxxxxxxxxxxxxxxxxxxxxxxxxxxxxxxxxxxxxxxxxxxxxxxxxxxxxxxxxxxxxxxxxxxxxxxxxxxxxxxxxxxxxxxxxxxxxxxxxxxxxxxxxxxxxxxxxxxxxxx
x                                                                                                                                                 x
x                                                                                                                                                 x
x                                                                                                                                                 x
x                                                                                                                                                 x
x                                                                                                                                                 x
x                                                                                                                                                 x
x                     P                                                                                                                           x
x                                                                                                                                                 x
x                                                                                                                                                 x
x                                                                                                                                                 x
x                                                                                                                                                 x
x                                                                                                                                                 x
x                                                                                                                                                 x
x                                                                                                                                                 x
x                                                                                                                                                 x
x                     zzzzzzz                                                                                                                     x
x                     zzzzzzz                                                                                                                     x
xxxxxxxxxxxxxxxxxxxxxxxxxxxxxxxxxxxxxxxxxxxxxxxxxxxxxxxxxxxxxxxxxxxxxxxxxxxxxxxxxxxxxxxxxxxxxxxxxxxxxxxxxxxxxxxxxxxxxxxxxxxxxxxxxxxxxxxxxxxxxxxxxxxxxxx




000000000000000000000000000000000000000000000000000000000000000000000000000000000000000000000000000000000000000000000000000000000000000000000000000
000000000000000000000000000000000000000000000000000000000000000000000000000000000000000000000000000000000000000000000000000000000000000000000000000
000000000000000000000000000000000000000000000000000000000000000000000000000000000000000000000000000000000000000000000000000000000000000000000000000
